111111111
100000001
101210121
100000201
101210101
100200001
111111111