1111111111
1001000011
1001010011
1002001001
1000000001
1001000201
1000000001
1001002001
1002010001
1111111111