1111111
1001011
1000101
1000101
1100001
1000011
1111111