111111111
100000001
121010101
120000001
101012101
100002001
111111111