11111111
10000011
10200001
11000001
10000201
10100001
11111111