1111111
1001011
1001111
1000001
1000001
1000021
1111111