11111111
10000001
10000001
11020001
10000001
12001001
11111111