1111111111
1001000011
1001010011
1000002001
1200000001
1001000001
1020002001
1001000001
1002002001
1111111111