111111111
100000001
101212101
100000001
101012121
100000001
111111111