1111111
1001011
1001111
1001001
1010001
1010101
1000001
1001211
1001111
1000001
1000001
1000001
1111111