1111111
1001011
1001111
1000001
1002021
1200021
1111111