1111111111
1001000011
1001010011
1002001021
1000002001
1100000201
1000100001
1001001001
1202020001
1111111111