111111111
100000001
101010101
102000201
101010101
100020001
111111111