1111111
1001011
1001111
1000001
1000001
1200001
1111111