111111
100101
100111
100021
111111