11111111
10000001
10100001
10020021
10000001
10100101
11111111