11111111
10010001
10002001
12000001
10010001
10002001
11111111