11111111111111
10204030403221
10010101010101
12020202030201
10101010141001
12020203444301
10101010141011
12020202030201
11111111111111